10 10
##.#######
#..#.#.#.#
#.##.....#
#.#..#.###
#.####.###
#.##.....#
#.##.###.#
#........#
#.######.#
########.#
